#$# ###
# ####
#######
### ##
##  ### 
# # # #
##### #
# #####
# #   #
@##  ##
